00000000000000000000000000000000000000000000
00000000000000000000000000000000000000000000
00001100000000000000000000001100000000000000
00000110000000000000000000011000000000000000
00000011000000000000000000110000000000000000
00000001100000000000000001100000000000000000
00000000110000000000000011000000000000000000
00000000011000000000000110000000000000000000
00000000000000000000000000000000000000000000
0000snake00000000000000000000000000000000000
00000000000000000000000000000000000000000000
00000000000000000000000000000000000000000000
00000000011000000000000001100000000000000000
00000000110000000000000000110000000000000000
00000001100000000000000000011000000000000000
00000011000000000000000000001100000000000000
00000110000000000000000000000110000000000000
00001100000000000000000000000011000000000000
00000000000000000000000000000000000000000000
00000000000000000000000000000000000000000000
